player 1,player 2,games played,win count,lose count,winrate
Carl3,Menander,25,21,4,0.84
Carl3,grandelich,27,22,5,0.8148148148148148
Carl3,Ncling,43,35,8,0.813953488372093
IBeSleepy,thePiedPiper,20,16,4,0.8
Carl3,Zerosun,61,48,13,0.7868852459016393
Bliitzii,Ncling,23,18,5,0.782608695652174
Bliitzii,thePiedPiper,23,18,5,0.782608695652174
Amelek,Carl3,23,18,5,0.782608695652174
Carl3,thePiedPiper,66,51,15,0.7727272727272727
Carl3,jumbobillybob,39,30,9,0.7692307692307693
Jimmy50,L4m3ness,26,20,6,0.7692307692307693
L4m3ness,Zerosun,30,23,7,0.7666666666666667
Maric_,Zerosun,47,36,11,0.7659574468085106
Carl3,Wazowski_,21,16,5,0.7619047619047619
Carl3,Jimmy50,46,35,11,0.7608695652173914
Carl3,cliff_build,24,18,6,0.75
Dr_Claw,cliff_build,20,15,5,0.75
Carl3,Maric_,54,40,14,0.7407407407407407
Carl3,cojito,37,27,10,0.7297297297297297
Bliitzii,Maric_,22,16,6,0.7272727272727273
Carl3,morganc,44,32,12,0.7272727272727273
Clutch331,Menander,22,16,6,0.7272727272727273
L4m3ness,qkratxa,22,16,6,0.7272727272727273
Dr_Claw,Smilingnasa,22,16,6,0.7272727272727273
Carl3,whittal,40,29,11,0.725
L4m3ness,thePiedPiper,29,21,8,0.7241379310344828
PaveV,proxc,25,18,7,0.72
cliff_build,thePiedPiper,25,18,7,0.72
Menander,morganc,32,23,9,0.71875
Carl3,proxc,32,23,9,0.71875
Ncling,cojito,21,15,6,0.7142857142857143
joschua725,thePiedPiper,21,15,6,0.7142857142857143
Bliitzii,Jimmy50,28,20,8,0.7142857142857143
Dr_Claw,Ncling,28,20,8,0.7142857142857143
ppvale,thePiedPiper,21,15,6,0.7142857142857143
Clutch331,Zerosun,52,37,15,0.7115384615384616
Jimmy50,cojito,38,27,11,0.7105263157894737
RedRafe,thePiedPiper,31,22,9,0.7096774193548387
Carl3,Walross123,24,17,7,0.7083333333333334
Carl3,justbob333,82,58,24,0.7073170731707317
cojito,thesoldier57,34,24,10,0.7058823529411765
Dr_Claw,kingofgugu,34,24,10,0.7058823529411765
Zerosun,greg-innovator,27,19,8,0.7037037037037037
IBeSleepy,Zerosun,27,19,8,0.7037037037037037
Amelek,thesoldier57,27,19,8,0.7037037037037037
Ncling,thesoldier57,37,26,11,0.7027027027027027
Jimmy50,Razgriz1711,30,21,9,0.7
Jimmy50,Maric_,40,28,12,0.7
Carl3,Razgriz1711,30,21,9,0.7
Carl3,POzilGeR,30,21,9,0.7
Dr_Claw,Eagle34,30,21,9,0.7
Jimmy50,whittal,33,23,10,0.696969696969697
Clutch331,Ncling,23,16,7,0.6956521739130435
Carl3,next_pro100_pro,23,16,7,0.6956521739130435
PaveV,thePiedPiper,52,36,16,0.6923076923076923
Jimmy50,qkratxa,39,27,12,0.6923076923076923
Carl3,ppvale,26,18,8,0.6923076923076923
Bliitzii,Zerosun,29,20,9,0.6896551724137931
Carl3,joschua725,29,20,9,0.6896551724137931
Jimmy50,Zerosun,61,42,19,0.6885245901639344
Zerosun,thePiedPiper,67,46,21,0.6865671641791045
Carl3,JuanMore,51,35,16,0.6862745098039216
Clutch331,Jimmy50,35,24,11,0.6857142857142857
Zerosun,wu524209138,22,15,7,0.6818181818181818
Arktischerozean,Carl3,22,15,7,0.6818181818181818
Carl3,bisti__,22,15,7,0.6818181818181818
Bliitzii,Clutch331,25,17,8,0.68
Maric_,morganc,31,21,10,0.6774193548387096
Bliitzii,Carl3,34,23,11,0.6764705882352942
Carl3,Eagle34,49,33,16,0.673469387755102
Clutch331,thePiedPiper,49,33,16,0.673469387755102
Jimmy50,Straightener,52,35,17,0.6730769230769231
Carl3,Dr_Claw,52,35,17,0.6730769230769231
Arktischerozean,Jimmy50,33,22,11,0.6666666666666666
Carl3,Clutch331,33,22,11,0.6666666666666666
Carl3,Straightener,48,32,16,0.6666666666666666
Maric_,PaveV,36,24,12,0.6666666666666666
Clutch331,developer,30,20,10,0.6666666666666666
greg-innovator,thePiedPiper,21,14,7,0.6666666666666666
Straightener,proxc,21,14,7,0.6666666666666666
jumbobillybob,thesoldier57,33,22,11,0.6666666666666666
Bliitzii,Dr_Claw,21,14,7,0.6666666666666666
Carl3,RuneBoggler,27,18,9,0.6666666666666666
Jimmy50,MartinMaxKing,27,18,9,0.6666666666666666
Carl3,Smilingnasa,21,14,7,0.6666666666666666
Amelek,Dr_Claw,33,22,11,0.6666666666666666
Jimmy50,thePiedPiper,59,39,20,0.6610169491525424
Carl3,qkratxa,47,31,16,0.6595744680851063
Jimmy50,gabrielchl,38,25,13,0.6578947368421053
Bliitzii,sticklord,35,23,12,0.6571428571428571
Carl3,TODY12321,32,21,11,0.65625
Clutch331,Straightener,26,17,9,0.6538461538461539
Ncling,Straightener,26,17,9,0.6538461538461539
Carl3,greg-innovator,26,17,9,0.6538461538461539
cojito,qkratxa,23,15,8,0.6521739130434783
jasongros619,jumbobillybob,23,15,8,0.6521739130434783
Amelek,Friendly_Fire,23,15,8,0.6521739130434783
Straightener,teomarx,20,13,7,0.65
Dr_Claw,proxc,20,13,7,0.65
Walross123,califerbopbop,20,13,7,0.65
Razgriz1711,thePiedPiper,37,24,13,0.6486486486486487
Carl3,RedRafe,37,24,13,0.6486486486486487
Jimmy50,Menander,37,24,13,0.6486486486486487
Arktischerozean,PaveV,31,20,11,0.6451612903225806
Jimmy50,massiveblue,31,20,11,0.6451612903225806
VortexT,thesoldier57,31,20,11,0.6451612903225806
Eagle34,PaveV,31,20,11,0.6451612903225806
Carl3,IBeSleepy,31,20,11,0.6451612903225806
Dr_Claw,IBeSleepy,31,20,11,0.6451612903225806
qkratxa,thePiedPiper,59,38,21,0.6440677966101694
Bliitzii,RedRafe,28,18,10,0.6428571428571429
Carl3,califerbopbop,67,43,24,0.6417910447761194
Jimmy50,PaveV,64,41,23,0.640625
PaveV,Zerosun,64,41,23,0.640625
Jimmy50,morganc,50,32,18,0.64
Straightener,cojito,25,16,9,0.64
Straightener,kingofgugu,25,16,9,0.64
Dr_Claw,RedRafe,25,16,9,0.64
Carl3,Friendly_Fire,25,16,9,0.64
Carl3,GuidoCram,36,23,13,0.6388888888888888
GuidoCram,thePiedPiper,36,23,13,0.6388888888888888
Carl3,wu524209138,33,21,12,0.6363636363636364
Ncling,RedRafe,22,14,8,0.6363636363636364
Dr_Claw,Irzinek,22,14,8,0.6363636363636364
kingofgugu,thePiedPiper,41,26,15,0.6341463414634146
Clutch331,Maric_,30,19,11,0.6333333333333333
Zerosun,joschua725,30,19,11,0.6333333333333333
Carl3,thesoldier57,87,55,32,0.632183908045977
Carl3,gabrielchl,38,24,14,0.631578947368421
Maric_,thesoldier57,54,34,20,0.6296296296296297
qkratxa,whittal,27,17,10,0.6296296296296297
Menander,qkratxa,27,17,10,0.6296296296296297
Dr_Claw,thesoldier57,62,39,23,0.6290322580645161
Carl3,SpaceDog786,35,22,13,0.6285714285714286
Zerosun,kingofgugu,43,27,16,0.627906976744186
Carl3,Gamingguy63,32,20,12,0.625
Ncling,proxc,24,15,9,0.625
Clutch331,RedRafe,24,15,9,0.625
CognitiveFun,cojito,32,20,12,0.625
POzilGeR,thePiedPiper,32,20,12,0.625
qkratxa,wu524209138,24,15,9,0.625
Dr_Claw,qkratxa,40,25,15,0.625
MartinMaxKing,Zerosun,32,20,12,0.625
MartinMaxKing,next_pro100_pro,24,15,9,0.625
Dr_Claw,Friendly_Fire,32,20,12,0.625
Bliitzii,qkratxa,29,18,11,0.6206896551724138
Zerosun,cojito,29,18,11,0.6206896551724138
Menander,thesoldier57,29,18,11,0.6206896551724138
joschua725,qkratxa,29,18,11,0.6206896551724138
Bliitzii,PaveV,29,18,11,0.6206896551724138
IBeSleepy,PaveV,29,18,11,0.6206896551724138
Bliitzii,teomarx,21,13,8,0.6190476190476191
Jimmy50,wu524209138,21,13,8,0.6190476190476191
Arktischerozean,SpaceDog786,21,13,8,0.6190476190476191
L4m3ness,justbob333,21,13,8,0.6190476190476191
Eagle34,developer,21,13,8,0.6190476190476191
PaveV,Virus0056,21,13,8,0.6190476190476191
Jimmy50,RuneBoggler,21,13,8,0.6190476190476191
Carl3,sticklord,76,47,29,0.618421052631579
cojito,sticklord,34,21,13,0.6176470588235294
Dr_Claw,developer,34,21,13,0.6176470588235294
Clutch331,gabrielchl,26,16,10,0.6153846153846154
developer,thePiedPiper,39,24,15,0.6153846153846154
thePiedPiper,thesoldier57,65,40,25,0.6153846153846154
Dr_Claw,Menander,26,16,10,0.6153846153846154
Carl3,teomarx,31,19,12,0.6129032258064516
Menander,thePiedPiper,31,19,12,0.6129032258064516
morganc,thePiedPiper,49,30,19,0.6122448979591837
cojito,justbob333,36,22,14,0.6111111111111112
Carl3,jasongros619,54,33,21,0.6111111111111112
Maric_,thePiedPiper,59,36,23,0.6101694915254238
Carl3,neuro666,69,42,27,0.6086956521739131
VortexT,neuro666,23,14,9,0.6086956521739131
Clutch331,joschua725,23,14,9,0.6086956521739131
greg-innovator,qkratxa,23,14,9,0.6086956521739131
Zerosun,proxc,23,14,9,0.6086956521739131
BAnana2023,Zerosun,28,17,11,0.6071428571428571
Maric_,Ncling,28,17,11,0.6071428571428571
Zerosun,cliff_build,28,17,11,0.6071428571428571
Friendly_Fire,PaveV,28,17,11,0.6071428571428571
Ncling,sticklord,33,20,13,0.6060606060606061
SpaceDog786,thePiedPiper,38,23,15,0.6052631578947368
Carl3,Fordeka,70,42,28,0.6
Pistachio.,justbob333,20,12,8,0.6
Bliitzii,joschua725,20,12,8,0.6
Clutch331,morganc,30,18,12,0.6
Menander,Zerosun,35,21,14,0.6
cojito,morganc,20,12,8,0.6
Jimmy50,RedRafe,35,21,14,0.6
PaveV,cojito,30,18,12,0.6
EPO666,Zerosun,20,12,8,0.6
greg-innovator,justbob333,25,15,10,0.6
Irzinek,thePiedPiper,30,18,12,0.6
Jimmy50,greg-innovator,25,15,10,0.6
VortexT,developer,20,12,8,0.6
Zerosun,developer,30,18,12,0.6
kingofgugu,qkratxa,35,21,14,0.6
gabrielchl,whittal,25,15,10,0.6
Menander,Razgriz1711,25,15,10,0.6
Jimmy50,jumbobillybob,20,12,8,0.6
POzilGeR,Straightener,20,12,8,0.6
Carl3,Virus0056,20,12,8,0.6
Carl3,MartinMaxKing,35,21,14,0.6
MartinMaxKing,Straightener,20,12,8,0.6
Amelek,Ncling,20,12,8,0.6
Jimmy50,sticklord,67,40,27,0.5970149253731343
sticklord,thePiedPiper,64,38,26,0.59375
Ncling,PaveV,32,19,13,0.59375
Ncling,califerbopbop,32,19,13,0.59375
proxc,thesoldier57,32,19,13,0.59375
califerbopbop,jumbobillybob,32,19,13,0.59375
Dr_Claw,GuidoCram,32,19,13,0.59375
Zerosun,qkratxa,59,35,24,0.5932203389830508
Zerosun,jumbobillybob,27,16,11,0.5925925925925926
Zerosun,next_pro100_pro,27,16,11,0.5925925925925926
bisti__,califerbopbop,27,16,11,0.5925925925925926
grandelich,justbob333,27,16,11,0.5925925925925926
MartinMaxKing,morganc,27,16,11,0.5925925925925926
VortexT,califerbopbop,22,13,9,0.5909090909090909
Clutch331,cliff_build,22,13,9,0.5909090909090909
thePiedPiper,whittal,44,26,18,0.5909090909090909
EPO666,thePiedPiper,22,13,9,0.5909090909090909
Eagle34,kingofgugu,22,13,9,0.5909090909090909
ppvale,thesoldier57,22,13,9,0.5909090909090909
cliff_build,justbob333,22,13,9,0.5909090909090909
Amelek,jasongros619,22,13,9,0.5909090909090909
justbob333,proxc,39,23,16,0.5897435897435898
justbob333,thePiedPiper,78,46,32,0.5897435897435898
Maric_,Straightener,34,20,14,0.5882352941176471
Ncling,Zerosun,34,20,14,0.5882352941176471
Clutch331,PaveV,34,20,14,0.5882352941176471
Friendly_Fire,thesoldier57,34,20,14,0.5882352941176471
Carl3,CognitiveFun,46,27,19,0.5869565217391305
BAnana2023,Maric_,29,17,12,0.5862068965517241
Arktischerozean,sticklord,29,17,12,0.5862068965517241
PaveV,RedRafe,29,17,12,0.5862068965517241
Maric_,developer,29,17,12,0.5862068965517241
99Names,Jimmy50,29,17,12,0.5862068965517241
Zerosun,thesoldier57,70,41,29,0.5857142857142857
Straightener,Zerosun,41,24,17,0.5853658536585366
Carl3,PaveV,65,38,27,0.5846153846153846
KawaiPurTales,qkratxa,24,14,10,0.5833333333333334
Bliitzii,JuanMore,24,14,10,0.5833333333333334
Bliitzii,Straightener,24,14,10,0.5833333333333334
Jimmy50,neuro666,72,42,30,0.5833333333333334
Fordeka,Maric_,48,28,20,0.5833333333333334
Irzinek,Razgriz1711,24,14,10,0.5833333333333334
Dr_Claw,thePiedPiper,48,28,20,0.5833333333333334
Straightener,TODY12321,24,14,10,0.5833333333333334
cojito,thePiedPiper,24,14,10,0.5833333333333334
Dr_Claw,POzilGeR,24,14,10,0.5833333333333334
Walross123,thesoldier57,24,14,10,0.5833333333333334
IBeSleepy,qkratxa,24,14,10,0.5833333333333334
Zerosun,morganc,55,32,23,0.5818181818181818
Bliitzii,Fordeka,31,18,13,0.5806451612903226
morganc,wu524209138,31,18,13,0.5806451612903226
justbob333,next_pro100_pro,31,18,13,0.5806451612903226
Bliitzii,califerbopbop,38,22,16,0.5789473684210527
Straightener,morganc,38,22,16,0.5789473684210527
developer,thesoldier57,38,22,16,0.5789473684210527
Carl3,developer,38,22,16,0.5789473684210527
califerbopbop,thePiedPiper,64,37,27,0.578125
Arktischerozean,justbob333,26,15,11,0.5769230769230769
morganc,qkratxa,26,15,11,0.5769230769230769
aparisi,thesoldier57,26,15,11,0.5769230769230769
Eagle34,JuanMore,26,15,11,0.5769230769230769
Eagle34,Zerosun,26,15,11,0.5769230769230769
cliff_build,thesoldier57,26,15,11,0.5769230769230769
Dr_Claw,jumbobillybob,26,15,11,0.5769230769230769
Jimmy50,justbob333,66,38,28,0.5757575757575758
Razgriz1711,Zerosun,33,19,14,0.5757575757575758
Pistachio.,thesoldier57,21,12,9,0.5714285714285714
BAnana2023,Carl3,28,16,12,0.5714285714285714
SpaceDog786,cojito,21,12,9,0.5714285714285714
Carl3,kingofgugu,49,28,21,0.5714285714285714
Bliitzii,thesoldier57,35,20,15,0.5714285714285714
PaveV,VortexT,21,12,9,0.5714285714285714
Maric_,POzilGeR,21,12,9,0.5714285714285714
cojito,outstanding,21,12,9,0.5714285714285714
Wazowski_,justbob333,21,12,9,0.5714285714285714
Straightener,thesoldier57,42,24,18,0.5714285714285714
greg-innovator,neuro666,21,12,9,0.5714285714285714
RedRafe,thesoldier57,35,20,15,0.5714285714285714
Clutch331,Dr_Claw,35,20,15,0.5714285714285714
Dr_Claw,Straightener,35,20,15,0.5714285714285714
Friendly_Fire,sticklord,21,12,9,0.5714285714285714
califerbopbop,grandelich,28,16,12,0.5714285714285714
grandelich,thesoldier57,28,16,12,0.5714285714285714
Friendly_Fire,Maric_,21,12,9,0.5714285714285714
IBeSleepy,TODY12321,21,12,9,0.5714285714285714
Irzinek,Zerosun,37,21,16,0.5675675675675675
IBeSleepy,thesoldier57,37,21,16,0.5675675675675675
GuidoCram,PaveV,30,17,13,0.5666666666666667
CognitiveFun,Menander,30,17,13,0.5666666666666667
Maric_,RedRafe,30,17,13,0.5666666666666667
IBeSleepy,neuro666,30,17,13,0.5666666666666667
Jimmy50,thesoldier57,53,30,23,0.5660377358490566
Bliitzii,gabrielchl,23,13,10,0.5652173913043478
Fordeka,VortexT,23,13,10,0.5652173913043478
VortexT,sticklord,23,13,10,0.5652173913043478
Zerosun,justbob333,69,39,30,0.5652173913043478
Irzinek,qkratxa,23,13,10,0.5652173913043478
Dr_Claw,Zerosun,46,26,20,0.5652173913043478
Eagle34,thePiedPiper,23,13,10,0.5652173913043478
Amelek,developer,23,13,10,0.5652173913043478
Zerosun,whittal,39,22,17,0.5641025641025641
Straightener,thePiedPiper,39,22,17,0.5641025641025641
Bliitzii,neuro666,32,18,14,0.5625
Carl3,Irzinek,32,18,14,0.5625
Carl3,RagnarLothbrok138,32,18,14,0.5625
Clutch331,califerbopbop,48,27,21,0.5625
Dr_Claw,Maric_,32,18,14,0.5625
cojito,gabrielchl,25,14,11,0.56
gabrielchl,jumbobillybob,25,14,11,0.56
joschua725,jumbobillybob,25,14,11,0.56
Jimmy50,hoponassu,25,14,11,0.56
Arktischerozean,gabrielchl,25,14,11,0.56
Eagle34,jasongros619,25,14,11,0.56
JuanMore,proxc,25,14,11,0.56
Zerosun,aparisi,27,15,12,0.5555555555555556
Fordeka,proxc,27,15,12,0.5555555555555556
Razgriz1711,sticklord,27,15,12,0.5555555555555556
RedRafe,qkratxa,27,15,12,0.5555555555555556
jumbobillybob,qkratxa,36,20,16,0.5555555555555556
Dr_Claw,Razgriz1711,27,15,12,0.5555555555555556
IBeSleepy,califerbopbop,36,20,16,0.5555555555555556
Maric_,justbob333,65,36,29,0.5538461538461539
SpaceDog786,thesoldier57,47,26,21,0.5531914893617021
Ncling,neuro666,38,21,17,0.5526315789473685
Razgriz1711,kingofgugu,29,16,13,0.5517241379310345
Menander,Ncling,29,16,13,0.5517241379310345
gabrielchl,morganc,29,16,13,0.5517241379310345
SpaceDog786,kingofgugu,29,16,13,0.5517241379310345
Ncling,qkratxa,29,16,13,0.5517241379310345
Dr_Claw,Jimmy50,29,16,13,0.5517241379310345
Menander,neuro666,49,27,22,0.5510204081632653
Carl3,massiveblue,40,22,18,0.55
KawaiPurTales,Zerosun,20,11,9,0.55
Irzinek,proxc,20,11,9,0.55
Ncling,thePiedPiper,40,22,18,0.55
RedRafe,massiveblue,20,11,9,0.55
JuanMore,teomarx,20,11,9,0.55
Eagle34,thesoldier57,40,22,18,0.55
morganc,next_pro100_pro,20,11,9,0.55
Fordeka,thePiedPiper,71,39,32,0.5492957746478874
Carl3,aparisi,31,17,14,0.5483870967741935
Arktischerozean,thesoldier57,31,17,14,0.5483870967741935
Ncling,joschua725,31,17,14,0.5483870967741935
PaveV,gabrielchl,31,17,14,0.5483870967741935
thePiedPiper,wu524209138,31,17,14,0.5483870967741935
jasongros619,thesoldier57,62,34,28,0.5483870967741935
JuanMore,kingofgugu,31,17,14,0.5483870967741935
jasongros619,kingofgugu,31,17,14,0.5483870967741935
Jimmy50,kingofgugu,42,23,19,0.5476190476190477
Ncling,justbob333,53,29,24,0.5471698113207547
califerbopbop,qkratxa,64,35,29,0.546875
Ncling,jumbobillybob,33,18,15,0.5454545454545454
Fordeka,Ncling,33,18,15,0.5454545454545454
gabrielchl,thesoldier57,33,18,15,0.5454545454545454
greg-innovator,thesoldier57,33,18,15,0.5454545454545454
Jimmy50,POzilGeR,22,12,10,0.5454545454545454
TODY12321,jumbobillybob,22,12,10,0.5454545454545454
jumbobillybob,thePiedPiper,33,18,15,0.5454545454545454
Max1000,thePiedPiper,22,12,10,0.5454545454545454
cojito,massiveblue,22,12,10,0.5454545454545454
Jimmy50,JuanMore,33,18,15,0.5454545454545454
PlumpCat,Zerosun,22,12,10,0.5454545454545454
Carl3,everLord,22,12,10,0.5454545454545454
califerbopbop,kingofgugu,46,25,21,0.5434782608695652
Maric_,qkratxa,46,25,21,0.5434782608695652
Jimmy50,SpaceDog786,35,19,16,0.5428571428571428
Maric_,Menander,24,13,11,0.5416666666666666
CognitiveFun,Jimmy50,48,26,22,0.5416666666666666
Menander,jasongros619,24,13,11,0.5416666666666666
Dr_Claw,PaveV,48,26,22,0.5416666666666666
PaveV,Razgriz1711,37,20,17,0.5405405405405406
gabrielchl,thePiedPiper,37,20,17,0.5405405405405406
Razgriz1711,justbob333,50,27,23,0.54
JuanMore,Maric_,39,21,18,0.5384615384615384
massiveblue,thePiedPiper,39,21,18,0.5384615384615384
proxc,thePiedPiper,26,14,12,0.5384615384615384
califerbopbop,whittal,39,21,18,0.5384615384615384
GuidoCram,TODY12321,26,14,12,0.5384615384615384
TODY12321,cojito,26,14,12,0.5384615384615384
Clutch331,kingofgugu,26,14,12,0.5384615384615384
JuanMore,developer,26,14,12,0.5384615384615384
GuidoCram,Zerosun,28,15,13,0.5357142857142857
Razgriz1711,thesoldier57,28,15,13,0.5357142857142857
BAnana2023,Jimmy50,28,15,13,0.5357142857142857
SpaceDog786,developer,28,15,13,0.5357142857142857
joschua725,sticklord,28,15,13,0.5357142857142857
califerbopbop,cojito,28,15,13,0.5357142857142857
Fordeka,cojito,28,15,13,0.5357142857142857
Amelek,sticklord,28,15,13,0.5357142857142857
Dr_Claw,califerbopbop,58,31,27,0.5344827586206896
PaveV,thesoldier57,75,40,35,0.5333333333333333
PaveV,whittal,30,16,14,0.5333333333333333
Clutch331,jumbobillybob,30,16,14,0.5333333333333333
JuanMore,cojito,30,16,14,0.5333333333333333
Maric_,kingofgugu,30,16,14,0.5333333333333333
Fordeka,Jimmy50,60,32,28,0.5333333333333333
RedRafe,Zerosun,45,24,21,0.5333333333333333
IBeSleepy,sticklord,30,16,14,0.5333333333333333
Dr_Claw,jasongros619,47,25,22,0.5319148936170213
PaveV,aparisi,32,17,15,0.53125
SpaceDog786,Zerosun,32,17,15,0.53125
Menander,Straightener,34,18,16,0.5294117647058824
PaveV,qkratxa,51,27,24,0.5294117647058824
PaveV,joschua725,36,19,17,0.5277777777777778
califerbopbop,massiveblue,36,19,17,0.5277777777777778
RagnarLothbrok138,thePiedPiper,36,19,17,0.5277777777777778
PaveV,TODY12321,36,19,17,0.5277777777777778
POzilGeR,Zerosun,36,19,17,0.5277777777777778
Menander,califerbopbop,36,19,17,0.5277777777777778
qkratxa,thesoldier57,55,29,26,0.5272727272727272
CognitiveFun,thePiedPiper,57,30,27,0.5263157894736842
thesoldier57,whittal,40,21,19,0.525
Friendly_Fire,justbob333,40,21,19,0.525
KawaiPurTales,sticklord,21,11,10,0.5238095238095238
Arktischerozean,Zerosun,21,11,10,0.5238095238095238
Maric_,jumbobillybob,21,11,10,0.5238095238095238
Maric_,wu524209138,21,11,10,0.5238095238095238
julianbrall,thePiedPiper,21,11,10,0.5238095238095238
Maric_,TODY12321,21,11,10,0.5238095238095238
RedRafe,developer,21,11,10,0.5238095238095238
Fordeka,Zerosun,63,33,30,0.5238095238095238
Zerosun,teomarx,21,11,10,0.5238095238095238
califerbopbop,ppvale,21,11,10,0.5238095238095238
Carl3,kravenstriker,21,11,10,0.5238095238095238
Dr_Claw,joschua725,21,11,10,0.5238095238095238
Smilingnasa,thesoldier57,21,11,10,0.5238095238095238
justbob333,kingofgugu,44,23,21,0.5227272727272727
MartinMaxKing,justbob333,44,23,21,0.5227272727272727
Jimmy50,aparisi,23,12,11,0.5217391304347826
Maric_,proxc,23,12,11,0.5217391304347826
developer,kingofgugu,23,12,11,0.5217391304347826
Clutch331,TODY12321,23,12,11,0.5217391304347826
VortexT,justbob333,23,12,11,0.5217391304347826
Dr_Claw,grandelich,23,12,11,0.5217391304347826
joschua725,thesoldier57,25,13,12,0.52
Eagle34,Straightener,25,13,12,0.52
Razgriz1711,developer,25,13,12,0.52
Clutch331,thesoldier57,50,26,24,0.52
jasongros619,thePiedPiper,50,26,24,0.52
99Names,Zerosun,25,13,12,0.52
Amelek,PaveV,25,13,12,0.52
Arktischerozean,neuro666,27,14,13,0.5185185185185185
Razgriz1711,jasongros619,27,14,13,0.5185185185185185
Virus0056,justbob333,27,14,13,0.5185185185185185
MartinMaxKing,qkratxa,27,14,13,0.5185185185185185
MartinMaxKing,PaveV,27,14,13,0.5185185185185185
qkratxa,sticklord,58,30,28,0.5172413793103449
morganc,whittal,29,15,14,0.5172413793103449
Irzinek,kingofgugu,29,15,14,0.5172413793103449
cliff_build,neuro666,29,15,14,0.5172413793103449
Bliitzii,justbob333,29,15,14,0.5172413793103449
GuidoCram,califerbopbop,31,16,15,0.5161290322580645
developer,qkratxa,31,16,15,0.5161290322580645
Clutch331,sticklord,31,16,15,0.5161290322580645
Jimmy50,teomarx,31,16,15,0.5161290322580645
RagnarLothbrok138,qkratxa,33,17,16,0.5151515151515151
99Names,thePiedPiper,33,17,16,0.5151515151515151
TODY12321,thePiedPiper,35,18,17,0.5142857142857142
Maric_,massiveblue,35,18,17,0.5142857142857142
Ncling,jasongros619,35,18,17,0.5142857142857142
CognitiveFun,Straightener,37,19,18,0.5135135135135135
morganc,sticklord,39,20,19,0.5128205128205128
Maric_,outstanding,39,20,19,0.5128205128205128
Dr_Claw,sticklord,39,20,19,0.5128205128205128
massiveblue,qkratxa,43,22,21,0.5116279069767442
califerbopbop,thesoldier57,88,45,43,0.5113636363636364
Clutch331,qkratxa,45,23,22,0.5111111111111111
Dr_Claw,Fordeka,47,24,23,0.5106382978723404
justbob333,morganc,49,25,24,0.5102040816326531
Maric_,sticklord,49,25,24,0.5102040816326531
Fordeka,PaveV,53,27,26,0.5094339622641509
Dr_Claw,neuro666,57,29,28,0.5087719298245614
Straightener,neuro666,67,34,33,0.5074626865671642
Fordeka,thesoldier57,81,41,40,0.5061728395061729
CognitiveFun,qkratxa,54,27,27,0.5
TODY12321,gabrielchl,28,14,14,0.5
califerbopbop,gabrielchl,30,15,15,0.5
gabrielchl,qkratxa,34,17,17,0.5
gabrielchl,sticklord,38,19,19,0.5
RagnarLothbrok138,kingofgugu,24,12,12,0.5
Razgriz1711,morganc,26,13,13,0.5
BAnana2023,morganc,28,14,14,0.5
Irzinek,Straightener,20,10,10,0.5
JuanMore,Ncling,30,15,15,0.5
JuanMore,Straightener,40,20,20,0.5
JuanMore,cliff_build,20,10,10,0.5
Straightener,gabrielchl,32,16,16,0.5
Straightener,joschua725,26,13,13,0.5
Arktischerozean,califerbopbop,26,13,13,0.5
CognitiveFun,PaveV,40,20,20,0.5
GuidoCram,sticklord,28,14,14,0.5
L4m3ness,sticklord,20,10,10,0.5
RedRafe,sticklord,40,20,20,0.5
BAnana2023,PaveV,34,17,17,0.5
Carl3,hoponassu,22,11,11,0.5
hoponassu,justbob333,22,11,11,0.5
neuro666,thePiedPiper,74,37,37,0.5
Carl3,L4m3ness,20,10,10,0.5
califerbopbop,joschua725,28,14,14,0.5
TODY12321,Zerosun,38,19,19,0.5
Irzinek,RagnarLothbrok138,22,11,11,0.5
RagnarLothbrok138,SpaceDog786,20,10,10,0.5
TODY12321,joschua725,24,12,12,0.5
Eagle34,SpaceDog786,28,14,14,0.5
Menander,PaveV,34,17,17,0.5
SpaceDog786,Straightener,28,14,14,0.5
Straightener,developer,26,13,13,0.5
Razgriz1711,qkratxa,32,16,16,0.5
Clutch331,GuidoCram,20,10,10,0.5
Jimmy50,jasongros619,26,13,13,0.5
Razgriz1711,Straightener,24,12,12,0.5
massiveblue,morganc,40,20,20,0.5
GuidoCram,JuanMore,26,13,13,0.5
RedRafe,Straightener,22,11,11,0.5
teomarx,thesoldier57,26,13,13,0.5
cojito,neuro666,34,17,17,0.5
hoch2oh,justbob333,20,10,10,0.5
Ncling,developer,34,17,17,0.5
Straightener,qkratxa,44,22,22,0.5
ppvale,sticklord,22,11,11,0.5
Dr_Claw,JuanMore,48,24,24,0.5
KawaiPurTales,thesoldier57,20,10,10,0.5
RuneBoggler,thePiedPiper,36,18,18,0.5
RuneBoggler,thesoldier57,52,26,26,0.5
Dr_Claw,cojito,22,11,11,0.5
Irzinek,RuneBoggler,22,11,11,0.5
99Names,Straightener,24,12,12,0.5
King...Crimson,califerbopbop,22,11,11,0.5
Maric_,MartinMaxKing,22,11,11,0.5
MartinMaxKing,thePiedPiper,32,16,16,0.5
MartinMaxKing,califerbopbop,24,12,12,0.5
IBeSleepy,RedRafe,22,11,11,0.5
Friendly_Fire,jumbobillybob,20,10,10,0.5
Friendly_Fire,thePiedPiper,30,15,15,0.5
Smilingnasa,justbob333,24,12,12,0.5
Friendly_Fire,jasongros619,24,12,12,0.5
Amelek,SpaceDog786,24,12,12,0.5
Dr_Claw,justbob333,57,28,29,0.49122807017543857
Clutch331,justbob333,55,27,28,0.4909090909090909
morganc,thesoldier57,49,24,25,0.4897959183673469
Straightener,sticklord,45,22,23,0.4888888888888889
Fordeka,jumbobillybob,45,22,23,0.4888888888888889
califerbopbop,developer,45,22,23,0.4888888888888889
neuro666,whittal,41,20,21,0.4878048780487805
Friendly_Fire,neuro666,41,20,21,0.4878048780487805
Amelek,neuro666,41,20,21,0.4878048780487805
Jimmy50,TODY12321,39,19,20,0.48717948717948717
TODY12321,qkratxa,37,18,19,0.4864864864864865
Zerosun,califerbopbop,74,36,38,0.4864864864864865
JuanMore,jumbobillybob,35,17,18,0.4857142857142857
Jimmy50,califerbopbop,70,34,36,0.4857142857142857
Zerosun,massiveblue,35,17,18,0.4857142857142857
Eagle34,neuro666,35,17,18,0.4857142857142857
Menander,sticklord,33,16,17,0.48484848484848486
Fordeka,Menander,33,16,17,0.48484848484848486
Fordeka,RedRafe,33,16,17,0.48484848484848486
Dr_Claw,aparisi,33,16,17,0.48484848484848486
PaveV,sticklord,64,31,33,0.484375
califerbopbop,greg-innovator,31,15,16,0.4838709677419355
CognitiveFun,morganc,29,14,15,0.4827586206896552
POzilGeR,justbob333,29,14,15,0.4827586206896552
SpaceDog786,TODY12321,27,13,14,0.48148148148148145
Menander,jumbobillybob,27,13,14,0.48148148148148145
GuidoCram,jasongros619,27,13,14,0.48148148148148145
Clutch331,jasongros619,27,13,14,0.48148148148148145
Gamingguy63,Zerosun,25,12,13,0.48
SpaceDog786,joschua725,25,12,13,0.48
morganc,neuro666,50,24,26,0.48
Maric_,RuneBoggler,25,12,13,0.48
RuneBoggler,developer,25,12,13,0.48
TODY12321,califerbopbop,46,22,24,0.4782608695652174
BAnana2023,SpaceDog786,23,11,12,0.4782608695652174
massiveblue,whittal,23,11,12,0.4782608695652174
TODY12321,kingofgugu,23,11,12,0.4782608695652174
Clutch331,Razgriz1711,23,11,12,0.4782608695652174
Eagle34,Jimmy50,23,11,12,0.4782608695652174
Amelek,califerbopbop,23,11,12,0.4782608695652174
Straightener,justbob333,67,32,35,0.47761194029850745
Straightener,califerbopbop,44,21,23,0.4772727272727273
Maric_,gabrielchl,21,10,11,0.47619047619047616
Menander,massiveblue,21,10,11,0.47619047619047616
Maric_,greg-innovator,21,10,11,0.47619047619047616
kravenstriker,morganc,21,10,11,0.47619047619047616
PaveV,RuneBoggler,21,10,11,0.47619047619047616
GuidoCram,RuneBoggler,21,10,11,0.47619047619047616
Fordeka,grandelich,21,10,11,0.47619047619047616
Menander,justbob333,40,19,21,0.475
PaveV,neuro666,76,36,40,0.47368421052631576
Zerosun,sticklord,57,27,30,0.47368421052631576
JuanMore,thesoldier57,57,27,30,0.47368421052631576
Clutch331,CognitiveFun,38,18,20,0.47368421052631576
Dr_Claw,SpaceDog786,38,18,20,0.47368421052631576
PaveV,jumbobillybob,36,17,19,0.4722222222222222
Eagle34,justbob333,36,17,19,0.4722222222222222
Fordeka,sticklord,70,33,37,0.4714285714285714
GuidoCram,thesoldier57,34,16,18,0.47058823529411764
RagnarLothbrok138,thesoldier57,34,16,18,0.47058823529411764
RedRafe,califerbopbop,51,24,27,0.47058823529411764
PaveV,Straightener,34,16,18,0.47058823529411764
PaveV,justbob333,83,39,44,0.46987951807228917
PaveV,califerbopbop,66,31,35,0.4696969696969697
Zerosun,neuro666,66,31,35,0.4696969696969697
Eagle34,Fordeka,32,15,17,0.46875
Fordeka,Straightener,64,30,34,0.46875
GuidoCram,qkratxa,32,15,17,0.46875
Dr_Claw,RuneBoggler,32,15,17,0.46875
MartinMaxKing,sticklord,32,15,17,0.46875
Fordeka,Friendly_Fire,32,15,17,0.46875
Razgriz1711,neuro666,47,22,25,0.46808510638297873
JuanMore,thePiedPiper,47,22,25,0.46808510638297873
Maric_,califerbopbop,62,29,33,0.46774193548387094
PaveV,morganc,45,21,24,0.4666666666666667
CognitiveFun,whittal,30,14,16,0.4666666666666667
GuidoCram,neuro666,43,20,23,0.46511627906976744
Straightener,outstanding,43,20,23,0.46511627906976744
kingofgugu,morganc,28,13,15,0.4642857142857143
Jimmy50,proxc,28,13,15,0.4642857142857143
aparisi,thePiedPiper,28,13,15,0.4642857142857143
Clutch331,SpaceDog786,28,13,15,0.4642857142857143
Maric_,jasongros619,28,13,15,0.4642857142857143
JuanMore,RedRafe,28,13,15,0.4642857142857143
99Names,thesoldier57,28,13,15,0.4642857142857143
Maric_,neuro666,54,25,29,0.46296296296296297
RagnarLothbrok138,Zerosun,26,12,14,0.46153846153846156
JuanMore,Zerosun,52,24,28,0.46153846153846156
CognitiveFun,kingofgugu,39,18,21,0.46153846153846156
sticklord,whittal,39,18,21,0.46153846153846156
GuidoCram,developer,26,12,14,0.46153846153846156
Straightener,jasongros619,39,18,21,0.46153846153846156
POzilGeR,PaveV,26,12,14,0.46153846153846156
MartinMaxKing,massiveblue,26,12,14,0.46153846153846156
justbob333,thesoldier57,89,41,48,0.4606741573033708
Fordeka,qkratxa,63,29,34,0.4603174603174603
PaveV,SpaceDog786,50,23,27,0.46
CognitiveFun,Zerosun,50,23,27,0.46
joschua725,neuro666,37,17,20,0.4594594594594595
CognitiveFun,developer,37,17,20,0.4594594594594595
CognitiveFun,sticklord,72,33,39,0.4583333333333333
Irzinek,Maric_,24,11,13,0.4583333333333333
proxc,sticklord,24,11,13,0.4583333333333333
Maric_,SpaceDog786,24,11,13,0.4583333333333333
massiveblue,wu524209138,24,11,13,0.4583333333333333
Dr_Claw,RagnarLothbrok138,24,11,13,0.4583333333333333
Virus0056,thesoldier57,24,11,13,0.4583333333333333
Fordeka,Smilingnasa,24,11,13,0.4583333333333333
Friendly_Fire,developer,24,11,13,0.4583333333333333
Amelek,justbob333,24,11,13,0.4583333333333333
RagnarLothbrok138,califerbopbop,35,16,19,0.45714285714285713
RuneBoggler,Zerosun,35,16,19,0.45714285714285713
PaveV,kingofgugu,46,21,25,0.45652173913043476
Fordeka,gabrielchl,33,15,18,0.45454545454545453
califerbopbop,teomarx,33,15,18,0.45454545454545453
RedRafe,neuro666,33,15,18,0.45454545454545453
Irzinek,Jimmy50,33,15,18,0.45454545454545453
massiveblue,thesoldier57,44,20,24,0.45454545454545453
Jimmy50,developer,22,10,12,0.45454545454545453
developer,gabrielchl,22,10,12,0.45454545454545453
PaveV,developer,33,15,18,0.45454545454545453
GuidoCram,jumbobillybob,22,10,12,0.45454545454545453
califerbopbop,cliff_build,22,10,12,0.45454545454545453
Dr_Claw,Max1000,22,10,12,0.45454545454545453
mircoboy,neuro666,22,10,12,0.45454545454545453
RedRafe,justbob333,31,14,17,0.45161290322580644
Fordeka,whittal,31,14,17,0.45161290322580644
jasongros619,qkratxa,31,14,17,0.45161290322580644
Gamingguy63,thePiedPiper,31,14,17,0.45161290322580644
developer,neuro666,51,23,28,0.45098039215686275
qkratxa,teomarx,20,9,11,0.45
kingofgugu,thesoldier57,60,27,33,0.45
BAnana2023,Irzinek,20,9,11,0.45
BAnana2023,Straightener,20,9,11,0.45
Clutch331,JuanMore,40,18,22,0.45
julianbrall,thesoldier57,20,9,11,0.45
EPO666,Maric_,20,9,11,0.45
RagnarLothbrok138,massiveblue,20,9,11,0.45
Dr_Claw,teomarx,20,9,11,0.45
POzilGeR,morganc,20,9,11,0.45
RagnarLothbrok138,jumbobillybob,20,9,11,0.45
cliff_build,sticklord,20,9,11,0.45
Straightener,whittal,20,9,11,0.45
Bliitzii,jasongros619,20,9,11,0.45
mgfist,neuro666,20,9,11,0.45
Fordeka,SpaceDog786,49,22,27,0.4489795918367347
Straightener,jumbobillybob,29,13,16,0.4482758620689655
Straightener,massiveblue,29,13,16,0.4482758620689655
califerbopbop,sticklord,76,34,42,0.4473684210526316
TODY12321,justbob333,38,17,21,0.4473684210526316
CognitiveFun,Dr_Claw,47,21,26,0.44680851063829785
SpaceDog786,qkratxa,45,20,25,0.4444444444444444
CognitiveFun,Razgriz1711,36,16,20,0.4444444444444444
Zerosun,jasongros619,36,16,20,0.4444444444444444
Dr_Claw,TODY12321,27,12,15,0.4444444444444444
Dr_Claw,gabrielchl,27,12,15,0.4444444444444444
RuneBoggler,justbob333,45,20,25,0.4444444444444444
IBeSleepy,justbob333,36,16,20,0.4444444444444444
Jimmy50,outstanding,61,27,34,0.4426229508196721
justbob333,qkratxa,61,27,34,0.4426229508196721
justbob333,whittal,34,15,19,0.4411764705882353
Zerosun,gabrielchl,34,15,19,0.4411764705882353
sticklord,thesoldier57,68,30,38,0.4411764705882353
Friendly_Fire,JuanMore,34,15,19,0.4411764705882353
Amelek,JuanMore,34,15,19,0.4411764705882353
SpaceDog786,sticklord,59,26,33,0.4406779661016949
SpaceDog786,justbob333,59,26,33,0.4406779661016949
GuidoCram,Razgriz1711,25,11,14,0.44
Gamingguy63,morganc,25,11,14,0.44
aparisi,jumbobillybob,25,11,14,0.44
L4m3ness,califerbopbop,25,11,14,0.44
POzilGeR,thesoldier57,25,11,14,0.44
Razgriz1711,califerbopbop,25,11,14,0.44
99Names,califerbopbop,25,11,14,0.44
IBeSleepy,Straightener,25,11,14,0.44
Fordeka,kingofgugu,41,18,23,0.43902439024390244
PaveV,jasongros619,41,18,23,0.43902439024390244
PaveV,outstanding,48,21,27,0.4375
CognitiveFun,Ncling,23,10,13,0.43478260869565216
Ncling,Razgriz1711,23,10,13,0.43478260869565216
GuidoCram,aparisi,23,10,13,0.43478260869565216
Max1000,Zerosun,23,10,13,0.43478260869565216
Dr_Claw,massiveblue,23,10,13,0.43478260869565216
MartinMaxKing,kingofgugu,23,10,13,0.43478260869565216
outstanding,thesoldier57,53,23,30,0.4339622641509434
aparisi,qkratxa,30,13,17,0.43333333333333335
GuidoCram,justbob333,30,13,17,0.43333333333333335
JuanMore,joschua725,30,13,17,0.43333333333333335
jasongros619,proxc,30,13,17,0.43333333333333335
Eagle34,califerbopbop,30,13,17,0.43333333333333335
aparisi,jasongros619,30,13,17,0.43333333333333335
JuanMore,PaveV,60,26,34,0.43333333333333335
justbob333,sticklord,88,38,50,0.4318181818181818
JuanMore,justbob333,65,28,37,0.4307692307692308
neuro666,qkratxa,79,34,45,0.43037974683544306
Fordeka,teomarx,21,9,12,0.42857142857142855
califerbopbop,julianbrall,21,9,12,0.42857142857142855
gabrielchl,neuro666,56,24,32,0.42857142857142855
Irzinek,morganc,28,12,16,0.42857142857142855
Straightener,aparisi,21,9,12,0.42857142857142855
L4m3ness,PaveV,21,9,12,0.42857142857142855
developer,sticklord,42,18,24,0.42857142857142855
justbob333,teomarx,21,9,12,0.42857142857142855
Razgriz1711,aparisi,21,9,12,0.42857142857142855
CognitiveFun,thesoldier57,56,24,32,0.42857142857142855
Razgriz1711,massiveblue,28,12,16,0.42857142857142855
Fordeka,morganc,35,15,20,0.42857142857142855
JuanMore,Max1000,21,9,12,0.42857142857142855
JuanMore,whittal,28,12,16,0.42857142857142855
CognitiveFun,RuneBoggler,35,15,20,0.42857142857142855
99Names,Clutch331,21,9,12,0.42857142857142855
CognitiveFun,IBeSleepy,21,9,12,0.42857142857142855
Amelek,qkratxa,21,9,12,0.42857142857142855
developer,everLord,21,9,12,0.42857142857142855
Clutch331,neuro666,61,26,35,0.4262295081967213
RagnarLothbrok138,justbob333,40,17,23,0.425
Menander,outstanding,40,17,23,0.425
justbob333,wu524209138,33,14,19,0.42424242424242425
developer,jumbobillybob,26,11,15,0.4230769230769231
sticklord,wu524209138,26,11,15,0.4230769230769231
Dr_Claw,whittal,26,11,15,0.4230769230769231
Irzinek,justbob333,38,16,22,0.42105263157894735
POzilGeR,califerbopbop,31,13,18,0.41935483870967744
Amelek,CognitiveFun,31,13,18,0.41935483870967744
TODY12321,sticklord,43,18,25,0.4186046511627907
RuneBoggler,califerbopbop,55,23,32,0.41818181818181815
TODY12321,neuro666,48,20,28,0.4166666666666667
EPO666,neuro666,36,15,21,0.4166666666666667
outstanding,thePiedPiper,60,25,35,0.4166666666666667
gabrielchl,kingofgugu,24,10,14,0.4166666666666667
Irzinek,thesoldier57,36,15,21,0.4166666666666667
BAnana2023,thePiedPiper,36,15,21,0.4166666666666667
jasongros619,massiveblue,24,10,14,0.4166666666666667
Clutch331,outstanding,36,15,21,0.4166666666666667
PlumpCat,thesoldier57,24,10,14,0.4166666666666667
99Names,PaveV,24,10,14,0.4166666666666667
Carl3,outstanding,41,17,24,0.4146341463414634
SpaceDog786,califerbopbop,41,17,24,0.4146341463414634
kingofgugu,sticklord,41,17,24,0.4146341463414634
Irzinek,PaveV,41,17,24,0.4146341463414634
joschua725,justbob333,41,17,24,0.4146341463414634
thesoldier57,wu524209138,29,12,17,0.41379310344827586
JuanMore,Menander,29,12,17,0.41379310344827586
CognitiveFun,Maric_,29,12,17,0.41379310344827586
Fordeka,Irzinek,29,12,17,0.41379310344827586
Eagle34,sticklord,29,12,17,0.41379310344827586
califerbopbop,wu524209138,29,12,17,0.41379310344827586
aparisi,califerbopbop,34,14,20,0.4117647058823529
califerbopbop,neuro666,68,28,40,0.4117647058823529
outstanding,qkratxa,51,21,30,0.4117647058823529
Fordeka,Razgriz1711,34,14,20,0.4117647058823529
JuanMore,gabrielchl,22,9,13,0.4090909090909091
GuidoCram,SpaceDog786,22,9,13,0.4090909090909091
PlumpCat,justbob333,22,9,13,0.4090909090909091
POzilGeR,qkratxa,22,9,13,0.4090909090909091
TODY12321,thesoldier57,44,18,26,0.4090909090909091
POzilGeR,sticklord,22,9,13,0.4090909090909091
RuneBoggler,whittal,22,9,13,0.4090909090909091
cogito123,neuro666,22,9,13,0.4090909090909091
bisti__,neuro666,22,9,13,0.4090909090909091
jasongros619,justbob333,49,20,29,0.40816326530612246
SpaceDog786,gabrielchl,27,11,16,0.4074074074074074
Razgriz1711,SpaceDog786,27,11,16,0.4074074074074074
Dr_Claw,Gamingguy63,27,11,16,0.4074074074074074
RuneBoggler,kingofgugu,27,11,16,0.4074074074074074
Clutch331,MartinMaxKing,27,11,16,0.4074074074074074
MartinMaxKing,thesoldier57,27,11,16,0.4074074074074074
Fordeka,IBeSleepy,27,11,16,0.4074074074074074
neuro666,thesoldier57,59,24,35,0.4067796610169492
Irzinek,JuanMore,32,13,19,0.40625
Fordeka,califerbopbop,74,30,44,0.40540540540540543
CognitiveFun,Friendly_Fire,37,15,22,0.40540540540540543
Irzinek,califerbopbop,47,19,28,0.40425531914893614
Clutch331,Fordeka,52,21,31,0.40384615384615385
CognitiveFun,SpaceDog786,45,18,27,0.4
neuro666,sticklord,100,40,60,0.4
Gamingguy63,Maric_,25,10,15,0.4
EPO666,sticklord,20,8,12,0.4
neuro666,proxc,20,8,12,0.4
outstanding,whittal,25,10,15,0.4
PaveV,massiveblue,30,12,18,0.4
RagnarLothbrok138,TODY12321,20,8,12,0.4
Fordeka,developer,30,12,18,0.4
hoponassu,massiveblue,20,8,12,0.4
developer,jasongros619,30,12,18,0.4
jumbobillybob,massiveblue,20,8,12,0.4
Gamingguy63,thesoldier57,35,14,21,0.4
jasongros619,morganc,25,10,15,0.4
Max1000,justbob333,20,8,12,0.4
PaveV,teomarx,20,8,12,0.4
jasongros619,teomarx,20,8,12,0.4
Clutch331,massiveblue,25,10,15,0.4
Carl3,Max1000,25,10,15,0.4
JuanMore,Razgriz1711,25,10,15,0.4
BuLLin9,qkratxa,20,8,12,0.4
BuLLin9,Carl3,20,8,12,0.4
CognitiveFun,joschua725,25,10,15,0.4
Fordeka,next_pro100_pro,20,8,12,0.4
mircoboy,outstanding,20,8,12,0.4
Zerosun,outstanding,58,23,35,0.39655172413793105
massiveblue,sticklord,48,19,29,0.3958333333333333
Fordeka,RuneBoggler,48,19,29,0.3958333333333333
jasongros619,neuro666,43,17,26,0.3953488372093023
99Names,qkratxa,28,11,17,0.39285714285714285
justbob333,massiveblue,51,20,31,0.39215686274509803
KawaiPurTales,gabrielchl,23,9,14,0.391304347826087
gabrielchl,outstanding,23,9,14,0.391304347826087
kingofgugu,whittal,23,9,14,0.391304347826087
greg-innovator,sticklord,23,9,14,0.391304347826087
EPO666,Fordeka,23,9,14,0.391304347826087
neuro666,ppvale,23,9,14,0.391304347826087
MartinMaxKing,neuro666,46,18,28,0.391304347826087
CognitiveFun,neuro666,90,35,55,0.3888888888888889
justbob333,neuro666,98,38,60,0.3877551020408163
califerbopbop,morganc,49,19,30,0.3877551020408163
julianbrall,neuro666,31,12,19,0.3870967741935484
JuanMore,aparisi,31,12,19,0.3870967741935484
EPO666,justbob333,31,12,19,0.3870967741935484
BAnana2023,thesoldier57,31,12,19,0.3870967741935484
Irzinek,sticklord,31,12,19,0.3870967741935484
Razgriz1711,outstanding,31,12,19,0.3870967741935484
Fordeka,GuidoCram,39,15,24,0.38461538461538464
JuanMore,RagnarLothbrok138,26,10,16,0.38461538461538464
developer,outstanding,39,15,24,0.38461538461538464
jumbobillybob,sticklord,26,10,16,0.38461538461538464
mipmop,neuro666,26,10,16,0.38461538461538464
Friendly_Fire,outstanding,39,15,24,0.38461538461538464
IBeSleepy,outstanding,26,10,16,0.38461538461538464
Fordeka,justbob333,86,33,53,0.38372093023255816
massiveblue,neuro666,60,23,37,0.38333333333333336
califerbopbop,justbob333,81,31,50,0.38271604938271603
CognitiveFun,justbob333,76,29,47,0.3815789473684211
Fordeka,KawaiPurTales,21,8,13,0.38095238095238093
KawaiPurTales,neuro666,21,8,13,0.38095238095238093
Irzinek,jasongros619,21,8,13,0.38095238095238093
CognitiveFun,Virus0056,21,8,13,0.38095238095238093
_dradeon_,neuro666,21,8,13,0.38095238095238093
PaveV,wu524209138,29,11,18,0.3793103448275862
JuanMore,morganc,29,11,18,0.3793103448275862
BAnana2023,califerbopbop,29,11,18,0.3793103448275862
Irzinek,neuro666,29,11,18,0.3793103448275862
Fordeka,TODY12321,37,14,23,0.3783783783783784
POzilGeR,neuro666,37,14,23,0.3783783783783784
RuneBoggler,sticklord,45,17,28,0.37777777777777777
SpaceDog786,neuro666,61,23,38,0.3770491803278688
califerbopbop,outstanding,61,23,38,0.3770491803278688
PaveV,RagnarLothbrok138,24,9,15,0.375
califerbopbop,proxc,32,12,20,0.375
BAnana2023,justbob333,32,12,20,0.375
kingofgugu,massiveblue,32,12,20,0.375
kingofgugu,neuro666,48,18,30,0.375
developer,justbob333,48,18,30,0.375
RedRafe,jasongros619,24,9,15,0.375
99Names,Fordeka,24,9,15,0.375
califerbopbop,next_pro100_pro,24,9,15,0.375
CognitiveFun,Fordeka,78,29,49,0.3717948717948718
Fordeka,POzilGeR,35,13,22,0.37142857142857144
Fordeka,aparisi,27,10,17,0.37037037037037035
califerbopbop,jasongros619,54,20,34,0.37037037037037035
outstanding,sticklord,76,28,48,0.3684210526315789
RuneBoggler,qkratxa,38,14,24,0.3684210526315789
Fordeka,jasongros619,49,18,31,0.3673469387755102
aparisi,sticklord,30,11,19,0.36666666666666664
Fordeka,joschua725,30,11,19,0.36666666666666664
Amelek,outstanding,30,11,19,0.36666666666666664
neuro666,outstanding,115,42,73,0.3652173913043478
CognitiveFun,teomarx,22,8,14,0.36363636363636365
EPO666,califerbopbop,22,8,14,0.36363636363636365
RedRafe,proxc,22,8,14,0.36363636363636365
SpaceDog786,proxc,22,8,14,0.36363636363636365
KawaiPurTales,justbob333,22,8,14,0.36363636363636365
RedRafe,aparisi,22,8,14,0.36363636363636365
outstanding,wu524209138,22,8,14,0.36363636363636365
mipmop,sticklord,22,8,14,0.36363636363636365
99Names,massiveblue,22,8,14,0.36363636363636365
99Names,justbob333,33,12,21,0.36363636363636365
99Names,morganc,22,8,14,0.36363636363636365
99Names,Maric_,22,8,14,0.36363636363636365
Fordeka,cogito123,22,8,14,0.36363636363636365
Fordeka,massiveblue,58,21,37,0.3620689655172414
Fordeka,RagnarLothbrok138,36,13,23,0.3611111111111111
aparisi,justbob333,36,13,23,0.3611111111111111
julianbrall,outstanding,25,9,16,0.36
jumbobillybob,justbob333,50,18,32,0.36
BAnana2023,CognitiveFun,25,9,16,0.36
Gamingguy63,neuro666,39,14,25,0.358974358974359
JuanMore,qkratxa,53,19,34,0.3584905660377358
aparisi,neuro666,42,15,27,0.35714285714285715
Max1000,neuro666,28,10,18,0.35714285714285715
RuneBoggler,jasongros619,28,10,18,0.35714285714285715
JuanMore,POzilGeR,28,10,18,0.35714285714285715
RuneBoggler,SpaceDog786,31,11,20,0.3548387096774194
CognitiveFun,gabrielchl,34,12,22,0.35294117647058826
CognitiveFun,JuanMore,51,18,33,0.35294117647058826
BAnana2023,sticklord,37,13,24,0.35135135135135137
JuanMore,wu524209138,20,7,13,0.35
outstanding,proxc,20,7,13,0.35
hoponassu,neuro666,20,7,13,0.35
BAnana2023,RuneBoggler,20,7,13,0.35
99Names,Menander,20,7,13,0.35
Dr_Claw,outstanding,43,15,28,0.3488372093023256
BAnana2023,Clutch331,23,8,15,0.34782608695652173
RedRafe,SpaceDog786,23,8,15,0.34782608695652173
morganc,outstanding,23,8,15,0.34782608695652173
SpaceDog786,jumbobillybob,23,8,15,0.34782608695652173
BuLLin9,neuro666,23,8,15,0.34782608695652173
Smilingnasa,outstanding,23,8,15,0.34782608695652173
everLord,neuro666,23,8,15,0.34782608695652173
Eagle34,gabrielchl,26,9,17,0.34615384615384615
Irzinek,outstanding,26,9,17,0.34615384615384615
POzilGeR,outstanding,26,9,17,0.34615384615384615
neuro666,teomarx,29,10,19,0.3448275862068966
Amelek,Fordeka,29,10,19,0.3448275862068966
Fordeka,JuanMore,61,21,40,0.3442622950819672
TODY12321,jasongros619,32,11,21,0.34375
sticklord,teomarx,35,12,23,0.34285714285714286
BAnana2023,Fordeka,35,12,23,0.34285714285714286
JuanMore,jasongros619,38,13,25,0.34210526315789475
jumbobillybob,neuro666,41,14,27,0.34146341463414637
JuanMore,sticklord,44,15,29,0.3409090909090909
jasongros619,sticklord,44,15,29,0.3409090909090909
Fordeka,neuro666,109,37,72,0.3394495412844037
CognitiveFun,aparisi,27,9,18,0.3333333333333333
CognitiveFun,outstanding,75,25,50,0.3333333333333333
julianbrall,sticklord,21,7,14,0.3333333333333333
Clutch331,Gamingguy63,21,7,14,0.3333333333333333
CognitiveFun,GuidoCram,21,7,14,0.3333333333333333
CognitiveFun,massiveblue,33,11,22,0.3333333333333333
RagnarLothbrok138,neuro666,36,12,24,0.3333333333333333
Ncling,outstanding,36,12,24,0.3333333333333333
Max1000,PaveV,24,8,16,0.3333333333333333
JuanMore,TODY12321,36,12,24,0.3333333333333333
abs_her,neuro666,21,7,14,0.3333333333333333
JuanMore,califerbopbop,57,19,38,0.3333333333333333
99Names,neuro666,42,14,28,0.3333333333333333
EPO666,JuanMore,21,7,14,0.3333333333333333
JuanMore,neuro666,73,24,49,0.3287671232876712
CognitiveFun,califerbopbop,49,16,33,0.32653061224489793
Gamingguy63,justbob333,34,11,23,0.3235294117647059
neuro666,wu524209138,31,10,21,0.3225806451612903
hoponassu,thesoldier57,28,9,19,0.32142857142857145
BAnana2023,qkratxa,28,9,19,0.32142857142857145
Irzinek,SpaceDog786,25,8,17,0.32
Gamingguy63,outstanding,25,8,17,0.32
RuneBoggler,neuro666,47,15,32,0.3191489361702128
CognitiveFun,julianbrall,22,7,15,0.3181818181818182
SpaceDog786,aparisi,22,7,15,0.3181818181818182
CognitiveFun,proxc,22,7,15,0.3181818181818182
DOgupus,morganc,22,7,15,0.3181818181818182
Gamingguy63,jasongros619,22,7,15,0.3181818181818182
BuLLin9,outstanding,22,7,15,0.3181818181818182
Fordeka,Max1000,22,7,15,0.3181818181818182
BAnana2023,neuro666,32,10,22,0.3125
BAnana2023,outstanding,29,9,20,0.3103448275862069
SpaceDog786,jasongros619,26,8,18,0.3076923076923077
JuanMore,massiveblue,26,8,18,0.3076923076923077
99Names,sticklord,26,8,18,0.3076923076923077
Fordeka,MartinMaxKing,49,15,34,0.30612244897959184
TODY12321,outstanding,36,11,25,0.3055555555555556
kingofgugu,outstanding,36,11,25,0.3055555555555556
Dr_Claw,MartinMaxKing,23,7,16,0.30434782608695654
CognitiveFun,TODY12321,30,9,21,0.3
BAnana2023,JuanMore,20,6,14,0.3
Gamingguy63,Straightener,20,6,14,0.3
RagnarLothbrok138,jasongros619,20,6,14,0.3
Razgriz1711,jumbobillybob,20,6,14,0.3
Friendly_Fire,SpaceDog786,20,6,14,0.3
JuanMore,SpaceDog786,37,11,26,0.2972972972972973
CognitiveFun,MartinMaxKing,37,11,26,0.2972972972972973
Gamingguy63,sticklord,27,8,19,0.2962962962962963
Gamingguy63,qkratxa,27,8,19,0.2962962962962963
RagnarLothbrok138,sticklord,34,10,24,0.29411764705882354
outstanding,teomarx,31,9,22,0.2903225806451613
MartinMaxKing,outstanding,38,11,27,0.2894736842105263
jasongros619,whittal,21,6,15,0.2857142857142857
joschua725,outstanding,21,6,15,0.2857142857142857
CognitiveFun,jumbobillybob,32,9,23,0.28125
Eagle34,outstanding,25,7,18,0.28
justbob333,outstanding,72,20,52,0.2777777777777778
gabrielchl,justbob333,36,10,26,0.2777777777777778
Gamingguy63,JuanMore,29,8,21,0.27586206896551724
Fordeka,outstanding,91,25,66,0.27472527472527475
Gamingguy63,RuneBoggler,22,6,16,0.2727272727272727
CognitiveFun,jasongros619,26,7,19,0.2692307692307692
CognitiveFun,RagnarLothbrok138,26,7,19,0.2692307692307692
RuneBoggler,outstanding,41,11,30,0.2682926829268293
SpaceDog786,outstanding,34,9,25,0.2647058823529412
99Names,outstanding,34,9,25,0.2647058823529412
DOgupus,califerbopbop,23,6,17,0.2608695652173913
SpaceDog786,massiveblue,23,6,17,0.2608695652173913
GuidoCram,outstanding,27,7,20,0.25925925925925924
Fordeka,Gamingguy63,27,7,20,0.25925925925925924
RagnarLothbrok138,outstanding,27,7,20,0.25925925925925924
RedRafe,outstanding,24,6,18,0.25
massiveblue,outstanding,32,8,24,0.25
CognitiveFun,POzilGeR,20,5,15,0.25
dog80,justbob333,20,5,15,0.25
itsmarkytime,neuro666,20,5,15,0.25
99Names,CognitiveFun,25,6,19,0.24
DOgupus,neuro666,21,5,16,0.23809523809523808
JuanMore,MartinMaxKing,21,5,16,0.23809523809523808
Friendly_Fire,qkratxa,21,5,16,0.23809523809523808
JuanMore,RuneBoggler,30,7,23,0.23333333333333334
jumbobillybob,outstanding,35,8,27,0.22857142857142856
Gamingguy63,PaveV,22,5,17,0.22727272727272727
califerbopbop,hoponassu,22,5,17,0.22727272727272727
aparisi,outstanding,27,6,21,0.2222222222222222
Clutch331,RuneBoggler,27,6,21,0.2222222222222222
CognitiveFun,EPO666,23,5,18,0.21739130434782608
RuneBoggler,TODY12321,23,5,18,0.21739130434782608
Friendly_Fire,califerbopbop,23,5,18,0.21739130434782608
jasongros619,outstanding,42,9,33,0.21428571428571427
JuanMore,outstanding,47,10,37,0.2127659574468085
BAnana2023,massiveblue,24,5,19,0.20833333333333334
Gamingguy63,califerbopbop,34,7,27,0.20588235294117646
Gamingguy63,RagnarLothbrok138,20,4,16,0.2
DOgupus,thesoldier57,20,4,16,0.2
mipmop,outstanding,20,4,16,0.2
